F                                                                                                  I
HF                                                                                                 I
AHF                                   EBBF                                                         I
AAHF                          EBBBBBBBGAAD                       l                 l               I
AAAHF                        EGAAAAAAAAAAD                                                       * I
AAAAHBBBBBBBBBBBBBBBBBBBBBBBBGAAAAAAAAAAAHBBBBBBBBBB   II  II     h        h       h      I   I  III