

F
D             I                                             E
D      II        I                                          C
D                     EBBBBBBF                              C
D         pq         EGAAAAAAD                            * C
HBBBBBBBBBBBBBBBBBBBBGAAAAAAAHBBBBBBBBBBBBBBBBBBBBBBBBBBBBBBG