

F
D             I                                             E
D      II        I     u  v                 s               C
D                     EBBBBBBF                    t         C
D    p     o      w  EGAAAAAAD      r                     * C
HBBBBBBBBBBBBBBBBBBBBGAAAAAAAHBBBBBBBBB  BBBBBBBBBBBBBBBBBBBG