

F
D             I                                             E
D      II        I     u  v                 s               C
D                     EBBBBBBF      r             t         C
D    p     o      w  EGAAAAAAD               c            * C
HBBBBBBBBBBBBBBBBBBBBGAAAAAAAHBBBBBBBBB  BBBBBBBBBBBBBBBBBBBG