

F
D             I                                             E
D      II        I     u  v                                 C
D                     EBBBBBBF                    t         C
D    p     o      w  EGAAAAAAD     r       s              * C
HBBBBBBBBBBBBBBBBBBBBGAAAAAAAHBBBBBBBBB  BBBBBBBBBBBBBBBBBBBG