F                                                            f                                     I
HF                                                                                                 I
AHF                   g               EBBF       I   h             I      e  b   III               I
AAHF             l            EBBBBBBBGAAD                                  III                    I
AAAHF r p q       m          EGAAAAAAAAAAD               II           III             I          * I
AAAAHBBBBBBBBBBBBBBBBBBBBBBBBGAAAAAAAAAAAHBBBBBBBBBB   II  II    III                      I   I  III
